****E****
*** *  **
** *** **
** **  **
*** * ***
*** * ***
*** * ***
****S****
*********  