****E****
***     *
** ***  *
**      *
***  ** *
** **   *     
*     S *
***     *
*********