****E****
*** *****
** *** **
** **  **
*** * ***
*** * ***
*** * ***
****S****
*********